00000000000000000000000000000
00000000000000000000000000000
00000000000000000000000000000
00000000000000000000111110000
00000000000000000001111111000
00000000000001100001111111000
00000000000011110001111110000
00000000000111110011111110000
00000000001111100011111111000
00000110011100000011100011000
00001111111000000011000011000
00001111111000000111000011000
00001111111101111111000011000
00001111111111111110000010000
00001111111111111100000110000
00001111111111111100000110000
00001111100111111110000110000
00001111000000001111001110000
00001111000000000111111110000
00001111000000000111111110000
00001111100000001111111110000
00011111110000001110001100000
00011111111000001100000000000
00001111111000000000000000000
00001111110000000000000000000
00000110000000000000000000000
00000000000000000000000000000
00000000000000000000000000000
00000000000000000000000000000