00000000000000000000000000000000000000000000
00000000000000000000000000000000000000000000
00000000000000000000000000000000000000000000
00000000000000000000000000000111110000000000
00000000000001111100000000001111111111000000
00000011111111111111110011111100011111100000
00001111111111111111111111111000001111100000
00011211110011111111111111111000001111000000
00011111100001111111111111111100001110000000
00011111100001111111111111111110000110000000
00011111110001111111111111111110000011000000
00011110111111111111111111110011000011100000
00011100011111111111111111100001100111100000
00011100000111111111111111110001111111000000
00011110000011111111111111111001111000000000
00001100000011111111111110011111110000000000
00000000000011111111111111111111100000000000
00000000000111111111111111111111100001100000
00000000001111111111000111111111100111110000
00000000011100111110000011100111111111110000
00000000011000000111000011000111111111110000
00000000011000000011100111100111111111100000
00000000001100000001111111111111111100000000
00000000000110000000111111111111111100000000
00000000000111000000000011111111111100000000
00000000001111111100000001111111111100000000
00000000111111111110000000111111111100000000
00000001111111111111001100011100011100000000
00000011111111111111111110000000001110000000
00000111111111111111111111000000001111000000
00001111111111111100011111100000011110000000
00001111100000110000001111110000111100000000
00001111000000000000001111110000111000000000
00001110000000000000000111110000111000000000
00011100000000000000000111110000111100000000
00011100000000000000000111111000111111100000
00011100000010000000001111111101111111110000
00011100000111001110011100111111111111110000
00001000000011113111111000011111111111100000
00000000000000111111110000011111111000000000
00000000000000000000000000001100000000000000
00000000000000000000000000000000000000000000
00000000000000000000000000000000000000000000
00000000000000000000000000000000000000000000
