00000000000000000000000000000000000000000000
00000000000000000000000000000000000000000000
00000000000000000000000000000000000000000000
00000000011000000001100000000000000000000000
00000000111111110011110000000011100000000000
00000000111111111111111100001111110000000000
00000001111100001100111111111111110000000000
00001111111000000000011111111111110001100000
00011111111000000000001111001111110011110000
00011111111100001100000110000111110011110000
00011111111111111110000110000111110111110000
00001111111111111110000011001111111111110000
00001111000001111100000001111111111110110000
00001110000000111100000001111111111100010000
00001110000000111000000000111111111100011000
00001111000001111000000000111111111000111000
00011111100011110000000001111100000001121000
00011111111111110001111111111000000001111000
00000000111111110001111111111000000000110000
00000000011111100001111111111100011100000000
00001000011111000000111111111111111110000000
00001100111110000000011111111111111111110000
00000111111110000000111111111111111111111000
00000011111111000000111111000000011111110000
00000001111111110001111110000000001100000000
00000000111111111111111100000000001000000000
00000000011111111111111000000000011000000000
00000000001100111111111000000000011000000000
00000000001100111111110000000000110000000000
00000000001100111111100000110000110000000000
00000000011000111111000001111001110000000000
00000000011000011111100011111111111000000000
00000000011000011111110011111111111000000000
00000000111100111111111001111111110000010000
00000111111100111111111000000011100000110000
00001111111111111111111000000000000000110000
00000111111111111111111000000000000000110000
00000011111111111001111100000000000000110000
00000001111111111000111111000011111001110000
00000001111111110000011111111111111111310000
00000000111100000000000000011110000011100000
00000000000000000000000000000000000000000000
00000000000000000000000000000000000000000000
00000000000000000000000000000000000000000000