00000000000000000000000000000
00000000000000000000000000000
00000000000000000000000000000
00000000000001100000000000000
00000000000111111111111100000
00000000001111111111111110000
00001110011111111111111110000
00011111111111100111111110000
00011111111111000011111110000
00001111101111000011111110000
00001111000011100111111110000
00001111100001111111111110000
00001111110001111111111110000
00001111111111111111111110000
00001111111111111111111111000
00001111111111111111001111000
00001111111111111100000110000
00000111111111111000000110000
00000000111111111000000110000
00000000111100111000000110000
00000001111000011000000110000
00000001110000011000000110000
00000000000000001100001110000
00000000000000000111111110000
00000000000000000011111100000
00000000000000000000000000000
00000000000000000000000000000
00000000000000000000000000000
00000000000000000000000000000