00000000000000000000000000000000000000000000
00000000000000000000000000000000000000000000
00000000000000000000000000000000000000000000
00000000000000000000000000000000000000000000
00001110000000111000001111000000000011100000
00011111000001111111111111110000000111110000
00011311000000112111100011110000000111110000
00011110000000001111100001110000000111110000
00001100000000000111100011110000001111110000
00001110000000000011111111100000001111110000
00001111111100000000111111100000000111111000
00001111111111000000011100110000000001111000
00001111111111100000011000011000000000110000
00001111110111100000011000011000000000110000
00001111111111110000011000001100000000110000
00001111111111111000011000001100000000110000
00001111111111111100011000011100000001110000
00001111111111111111111000111110000111110000
00011110011111111111111001111111111111110000
00011100001111111111111001111111111111111000
00001100000111111111111000111110000011111000
00001100000011111111111000011110000011110000
00011110000011111111111000001110000111110000
00011110000111110001111100000111111111110000
00011111001111100000111110000111111111110000
00001111111111100000011111000111111111100000
00001111111111110000000011100111111111000000
00001111111111111000000001100111111110000000
00001110111100111000000001111111111110000000
00001100001000000000100001111111111110000000
00001100000000000001100001111111111111000000
00001100000000000001100001111111111111100000
00001110000000000001100001111111111111110000
00000111000000000000110011111111111111110000
00000111100000000000111111111111111000110000
00000111111111111001111111111111111000110000
00000111111111111111111111111111111111110000
00001111111111111111100011111111111111110000
00001111111111000111000001111111111111100000
00000111111100000000000000111111111111000000
00000000000000000000000000000000000000000000
00000000000000000000000000000000000000000000
00000000000000000000000000000000000000000000
00000000000000000000000000000000000000000000