00000000000000000000000000000
00000000000000000000000000000
00000000000000000000000000000
00000000001100000001100000000
00000000011111000011111100000
00000000110011131110001110000
00000001100000111100000110000
00000011000000000000000110000
00000111000000000000000010000
00001111000000000000000011000
00001111100000000110000011000
00011111110000001111000011000
00011111110000011111000011000
00001111110000111111100110000
00000111100001111111111110000
00000111100001111111111110000
00000111110001111111111110000
00000111111111111111111110000
00000111001111111111111100000
00001111000111111111100000000
00001111100011111100000000000
00001111110001111000000000000
00000111111001111000000000000
00000000011111111100000000000
00000000001111111111100000000
00000000000000111211100000000
00000000000000000000000000000
00000000000000000000000000000
00000000000000000000000000000