00000000000000000000000000000000000000000000
00000000000000000000000000000000000000000000
00000000000000000000000000000000000000000000
00000111100000000000000000000011111100000000
00001113100000011110011100000111111110000000
00001111100000111111111110000111101110000000
00001110000000111111111111000011100111000000
00001110000000111111111111100001101111100000
00001111110000111111111111100000111111100000
00001111111000111111111111100000111111100000
00000111111000011111111111100000001111100000
00000001111100001111111111110000000011100000
00000000111110001111111111111100000011110000
00000000000011011111111000011110000011110000
00000000000001111111111000011110000011111000
00000000000001111111111000011111000011111000
00000000000001111111111111111111100111110000
00000000000001111111111111111111111111110000
00000110000001111111111001111111111111100000
00000110000001111111110000111110000011100000
00001100000001111111110000111100000001110000
00001100000000111111111001111100000000111000
00001110000000111111111111111100000000111000
00000111000001111111101111111100000000110000
00000011000001111111000111111100000000110000
00000001100001111111101111111100000001100000
00000000110011110011111111111110000001100000
00000000111111100001111111111110000000110000
00000000111111100001111111001100110000110000
00000000111111110011111111000001111000110000
00000000111000111111111111000001111000010000
00000001111000111111111111000011111000011000
00000001111101111101111111001111111100111000
00000011111111111111111110011111111111111000
00000111111111111111100000011111111111110000
00001111111111111111000000111111111110000000
00011111110011111111100001111111111100000000
00011111100001111121111111111111111000000000
00011111100001111111111111111111111000000000
00001111000000111111100011111111111000000000
00000000000000000011000000011001110000000000
00000000000000000000000000000000000000000000
00000000000000000000000000000000000000000000
00000000000000000000000000000000000000000000