00000000000000000000000000000
00000000000000000000000000000
00000000000000000000000000000
00000000111111000000000000000
00000111211111100000011100000
00001110000001110000111110000
00001100000000010000111110000
00001100000000000000111100000
00001100000000000000111000000
00001100000000000001100000000
00011110000000000011000000000
00011111100000000111000000000
00011111111001111111100000000
00011111111111111111111100000
00011111111111111111111110000
00001111111111111111111110000
00001111111111111111111100000
00001110000111111111111100000
00001110000011111111111000000
00001110000000011111111000000
00001111110000011001111100000
00001111111000011101111110000
00001111111111111111111110000
00000111111111111111111100000
00000000000111001111131100000
00000000000000000011111000000
00000000000000000000000000000
00000000000000000000000000000
00000000000000000000000000000