00000000000000000000000000000000000000000000
00000000000000000000000000000000000000000000
00000000000000000000000000000000000000000000
00001110000000000000000000000000000000000000
00011111111111001100000111100000011110000000
00012111111111111110001111110000111111000000
00011111111111111111111111110000111111000000
00011111111111111001111111111001111110000000
00011111111111110000011111111111111100000000
00011111111111111000011111111111111000000000
00011111111111111111111111111001111000000000
00011111011111111111111111110000011100000000
00011111111111111001111101110000001110000000
00011111111001110000111001111000000110000000
00001111110000110000011111111100000110000000
00001111100000110000011111111110000110000000
00001111100000011000011111111110000111000000
00001111110000001100111111111110000011100000
00000111111000000111111110111111000001110000
00000011111000000011111110111111110000110000
00000011111100000011111111114111111000011000
00000111111111000111111111111111111000011000
00001111111111111111111111111111111000110000
00011111111100111100011111001111110011110000
00011111111000011000001111001111000111100000
00011111111000011000001111111100000111100000
00011111110000011000000111111000000111110000
00011111100000110000000111111000000111111000
00001111100000110000000111111000001111111000
00000111100000111001100011111000011111110000
00000111110001111111110001110000111111100000
00000111111111111111110000000000111111000000
00000111111111111111110000000000111111000000
00001111111000011111110000000000011111000000
00001111110000001111110000000000001111000000
00001111110000001111111111110000001110000000
00001111110000001111111111111000011100000000
00001111111000011111111100011100111000000000
00001111111111111111111000001111110000000000
00001111111111111100000000000111100000000000
00000111000000000000000000000000000000000000
00000000000000000000000000000000000000000000
00000000000000000000000000000000000000000000
00000000000000000000000000000000000000000000