0000000000000000000000000000000
0000000000000000000000000000000
0000000000000000000000000000000
0000000000000000001110000000000
0000011111100110011111110000000
0000111111111111111111111000000
0000111111111111111001111000000
0000111111111111110000111000000
0001111111111111000001111100000
0001111111111110000001111110000
0000111111111100000000111111000
0000111111011100000000011111000
0000111111111110000000011111000
0001111111111111111111111111000
0001111111111111111111111111000
0000111111111100000000111110000
0000111111111100000000011100000
0000111111111110000000000000000
0000111111111110000000000000000
0000111111111100000000000000000
0000111111011100000000000000000
0000011110001100000000111000000
0000001110001110000001111100000
0000001111111111100011111100000
0000001111111111111111111000000
0000001111111111111111000000000
0000001111111110001110000000000
0000000111111000000000000000000
0000000000000000000000000000000
0000000000000000000000000000000
0000000000000000000000000000000