000000000000000000000000000000000000000
000000000000000000000000000000000000000
000000000000000000000000000000000000000
000000000000000000000000000000011100000
000011000001110000000001100000111110000
000111100011111000001111110000111110000
000121110111111100011111110000011111000
000111111111111111111111100000011111000
000111111111111111111111100000011111000
000011111111100000111111110000111111000
000000001111000000011111111001111111000
000000000000000000011111111111111110000
000000000000000000011111111111111110000
000000000000000000001111111111111110000
000000000000111100000111000111111110000
000001111001111110000000000011111110000
000001111111111111000000000011100100000
000001111111111111111100000111000000000
000000011111111111111110000110000000000
000000001111111111111110000110000000000
000000001111000111111100000011000000000
000000011110000111111100000001100000000
000001111000000011111100000001100000000
000011110000000001111110000001100000000
000011110000000001111110000011000000000
000011111000000001111111000011000000000
000011111100000000111111100110000000000
000011111110000000011111111110000110000
000111111110000000001111111110000110000
000111111100000000001111111111001110000
000111111100000000000111110111111110000
000111111100000000000111100111111110000
000111111110000000001111110111001100000
000113111110000000011111111110000000000
000011111110000000011111111100000000000
000000011100000000000000000000000000000
000000000000000000000000000000000000000
000000000000000000000000000000000000000
000000000000000000000000000000000000000
