00000000000000000000000000000
00000000000000000000000000000
00000000000000000000000000000
00000000000000000000000000000
00000000000011000000000000000
00000111111111100110000000000
00001111111111111111000000000
00001111111111111111101100000
00001111111111111111111110000
00001111111111111111113110000
00001111111111111111111110000
00000111111111111111111110000
00000111111111111111100110000
00000111000001111111000010000
00000110000000111111000011000
00000110000000111111100111000
00000111000000111111111111000
00000111110000111111111111000
00001111111000111110001110000
00011111111101111100000110000
00011111111111111100000110000
00011111111111111110001110000
00011111111111111111111110000
00011211111111100011111110000
00011111111111000000001100000
00001111111110000000000000000
00000000000000000000000000000
00000000000000000000000000000
00000000000000000000000000000
