00000000000000000000000000000
00000000000000000000000000000
00000000000000000000000000000
00000001111000000011000000000
00000011111100011111111000000
00000011111131111000011100000
00000011100111000000001100000
00000111000000000000001100000
00000111000000000000000110000
00001111101111100000000110000
00001111111111110000001111000
00000111111111111001111111000
00000111111111111111111111000
00000011111111111111111110000
00000001111111111111111000000
00000001111111111111111000000
00000011100111111000110000000
00000111000011110000010000000
00001110000001100000000000000
00011100000001100000000000000
00011000000001110000000000000
00001000000011110000000000000
00001100000011110000000000000
00001110000111111000000000000
00001111111111111112110000000
00000111111000111111100000000
00000000000000000000000000000
00000000000000000000000000000
00000000000000000000000000000