000000000000000000000000000000000000000
000000000000000000000000000000000000000
000000000000000000000000000000000000000
000000000000000000000000000000000000000
000000011110000000001110000000001100000
000000111111110000011111111000011110000
000000111111111000111111111111113110000
000001111111111111111111111111111100000
000011111111111111111111111111111000000
000011111111111111111111111111110000000
000011111111111110011111111111110000000
000011100011111111111111111111100000000
000011000000000111111111111111000000000
000011000000000011111111111110000000000
000011000000000011111111111110000000000
000001100000000001111111111111000000000
000001111100000000111111111111000000000
000000111111100000011111111111000000000
000000011111110000011111111111000000000
000000001111111000111100011111100000000
000000001111111111111000001111100000000
000000001111111111110000001111110000000
000011111110000110000000001110011000000
000111111100000000000000001100001100000
000111111100000000000000011110011110000
000111111000000000000000111111111110000
000111111000001000000011111111111110000
000111111000011100000011111111111111000
000111111100111110000011111111111111000
000012111111111111000000000111111111000
000011111111111111100000000111111111000
000001100001111111100000001111111110000
000000000000111100110000111111111110000
000000000000011000011111111111111100000
000000000000000000001110001111000000000
000000000000000000000000000110000000000
000000000000000000000000000000000000000
000000000000000000000000000000000000000
000000000000000000000000000000000000000