000000000000000000000000000000000000000
000000000000000000000000000000000000000
000000000000000000000000000000000000000
000000000011110000000000000000000000000
000001111111111100011111111111110000000
000011311011111111111111111111111100000
000011110001111111111000000000111110000
000011110011111111110000000000111110000
000011111111111111100000000001111110000
000001111111111111000000000011111110000
000001111111111100000000000011111110000
000001111111110000001111100001100000000
000001101111100000011111110001100000000
000011000111000000011111111011100000000
000110001110000000011111111111000000000
000110000100000000001111111111000011000
000111000000000000000111111110000011000
000111100000000000000111111110000011000
000011110000000000000111111111000011000
000001111111110000001111111111100111000
000000111111111000011111110001111110000
000000111111111100111111110000011110000
000001111111001111111111111000001110000
000001111111000111111111111000001100000
000001111111000001111111111100011100000
000000111111100000111111111111111100000
000000111111110000011111111111111100000
000000111111110000001111111111111110000
000001111111110000000111111111111110000
000001111111110000000111111111111110000
000011111111111000000111111111111110000
000011111111111100000110011111111110000
000011111111111110000000001111111110000
000001111111111111000000001111111110000
000000011111111211000000000110011100000
000000000000001110000000000000000000000
000000000000000000000000000000000000000
000000000000000000000000000000000000000
000000000000000000000000000000000000000