00000000000000000000000000000
00000000000000000000000000000
00000000000000000000000000000
00000000000000000000000000000
00000000111111111111111000000
00000001111111111111111100000
00000001111111111111111100000
00000011111111111111111100000
00000111111111111111111110000
00001111111111111111111110000
00001211111111111111111110000
00001111111110000111111110000
00001111111100000111001110000
00001111111110001110000110000
00001111111111111100000110000
00001111111111111000001110000
00001111111111111001111111000
00000111111111111111111111000
00000011111111111100111111000
00000001111111111000011111000
00000001111111111000011110000
00000001111111111100111110000
00000000111111111111111310000
00000000111111111111111110000
00000000011111111000011100000
00000000000000000000000000000
00000000000000000000000000000
00000000000000000000000000000
00000000000000000000000000000