00000000000000000000000000000
00000000000000000000000000000
00000000000000000000000000000
00000000000000111100001100000
00000000011111111111111110000
00000000111111111111111110000
00001111111111111111111100000
00011111111111110000111100000
00012111111111100000011100000
00011111111001100000011110000
00001111111000110000111110000
00000111111000011111111110000
00000111111000001111111111000
00000111111000000000000111000
00000111111000000000000111000
00001111111111110000000110000
00011111111111111100000110000
00011111111111111110000110000
00011111111111111110000011000
00011111111111111110000011000
00011111111001100000000110000
00011111110000000000000110000
00011111110000000000000110000
00001111100000000000001110000
00000000000000000001131110000
00000000000000000001111100000
00000000000000000000000000000
00000000000000000000000000000
00000000000000000000000000000