000000000000000000000000000000000000000
000000000000000000000000000000000000000
000000000000000000000000000000000000000
000000000000000000000000001110000110000
000000000000000000011000011111111111000
000000000000111111111111110011111111000
000000000001111111111111100011111110000
000011100011111000011110000011111100000
000111100011110000000000000111111100000
000113100011100000000000000111100110000
000111100111000000000011000011000011000
000011100111000000000111000011000011000
000011111111111111001110000110000011000
000011111111111111111110011100000011000
000011111111111111111100111100000111000
000011111111111111111100111100111111000
000011111111111111111000011111111110000
000011100000001111000000011111111100000
000011000000000000000000011111111000000
000011000000000000000000001111111100000
000011000000000000000000000011111110000
000011000000000000000000000001111111000
000001100000011000000000000000111111000
000001110000111100000111000000011111000
000001111111111110001111100000001110000
000000111111111111111111110000000110000
000000011111111111111111110000000110000
000000000111111111111111100000000110000
000000000011111111111111100000000110000
000011000111111111111111000000000110000
000011111111111111111110000000000110000
000011111111111111111111011000000110000
000011111111111111111111111100000110000
000011111111111111111111111110001111000
000001100001111110001111111111111211000
000000000000000000000111001111111110000
000000000000000000000000000000000000000
000000000000000000000000000000000000000
000000000000000000000000000000000000000
