000000000000000000000000000000000000000
000000000000000000000000000000000000000
000000000000000000000000000000000000000
000000000000000001111110000000000000000
000000000000001111111111111111111110000
000011111110011111111111111111111111000
000111111111111000111111111111111211000
000111111111100000111111111111111110000
000111100011000000111111111111111110000
000111000000000000111111111111111100000
000011100000000110011111111111111100000
000011110000001111000111111111111110000
000011111000011111100011111001111110000
000111111100111111110111110000111110000
000111111111111111111111110000111100000
000011111111111111111111111001111000000
000000111111111111111111111111110000000
000001111111111114111111111111110000000
000011111111111111111111111111111000000
000111111111111111111111110000011110000
000111111111111111111111100000000111000
000111111111111111111111000000000011000
000111111001111111111111000000000011000
000111110000111111100111000000000010000
000111110000111111000011000011000110000
000111111001111111000011000111111110000
000111111111111111100110001111111110000
000111111111111111111100011111111100000
000011100011000111111000011101111000000
000011000000000000000000111101111000000
000011000000000000000111111111111000000
000011100000000000001111111111111000000
000001111111100000011111111111110000000
000000111111110011111111111100000000000
000000011111111111111111110000000000000
000000001111111000011000000000000000000
000000000000000000000000000000000000000
000000000000000000000000000000000000000
000000000000000000000000000000000000000
