0000000000000000000000000000000
0000000000000000000000000000000
0000000000000000000000000000000
0000000000011111000000000000000
0000111001111111100000000000000
0001111111111111111100000000000
0001111111111111111110000000000
0001111411111111111110000000000
0000111111111111111100000000000
0000111111111111000000000000000
0000111111111111000000000000000
0001111111111111001111111100000
0001111111111111111111111110000
0001111111111111111111111111000
0001111111111111111011111111000
0001111111111111110001111110000
0001111111111100111000111110000
0001111111111000011000111110000
0000111111111000011000111110000
0000011111111100111001111111000
0000011000111111110001111111000
0000110000011111110001111111000
0000110000011111110001111110000
0000110000011111111001111110000
0000110000111111111111111110000
0000011001111111111121111100000
0000001111111110001111111000000
0000000110011100000001110000000
0000000000000000000000000000000
0000000000000000000000000000000
0000000000000000000000000000000