0000000000000000000000000000000000
0000000000000000000000000000000000
0000000000000000000000000000000000
0000000000000000001111000000000000
0000001110000000011111111000000000
0000011111100000111111111111000000
0000011211110001111111111131100000
0000001111110001111111111111000000
0000000111100000111110011110000000
0000000111100000111100001100000000
0000000111100000111000000000000000
0000000111110000111000000001100000
0000001111111001111000001111100000
0000001111111111111000011111100000
0000001111111111111100111111100000
0000001111111111111111111111100000
0000001111111111111111111111100000
0000000111111111111111111111100000
0000000111111111111111111111000000
0000000011111111111111111110000000
0000000011111100111111111100000000
0000000111100000011111111000000000
0000111111000000011111111000000000
0001111111000000111111111000000000
0001111111100001111111111100000000
0000111111100001111101111110000000
0000000111110000111100111111000000
0000000011111000011101111111000000
0000000011111000011111111111000000
0000000001110000001110011110000000
0000000000000000000000000000000000
0000000000000000000000000000000000
0000000000000000000000000000000000
0000000000000000000000000000000000
