0000000000000000000
0000000000000000000
0000000000000000000
0000000011100000000
0000001111111100000
0000011111111110000
0000011111111110000
0000011111111110000
0000011111111110000
0000011111111110000
0000011100001111000
0000011100000111000
0000011100001111000
0000111100001311000
0000121100001110000
0000011000000000000
0000000000000000000
0000000000000000000
0000000000000000000
