0000000000000000000
0000000000000000000
0000000000000000000
0000000000000000000
0000011100011000000
0000131111111100000
0000110011111100000
0000100001111110000
0001100001111110000
0001100001111111000
0001100001111111000
0001110011111111000
0000111111111211000
0000011110001110000
0000001100000000000
0000000000000000000
0000000000000000000
0000000000000000000
0000000000000000000
