0000000000000000000000000000000000
0000000000000000000000000000000000
0000000000000000000000000000000000
0000001110000000110000000000000000
0000011111000011110000000011000000
0000011111100111110000000113100000
0000001111111111100000001111110000
0000000111111111100000011100111000
0000000011111111110000111000011000
0000000011111111111000111000110000
0000000011111111111001111001100000
0000000111100111111001111111100000
0000001111100011110000111111100000
0000011111111000000000000111100000
0000111001111100000000000011100000
0000110000001110000010000011100000
0000110000000110000111000011100000
0000111000000011001111100011100000
0000111111100001111111100001110000
0000111111110000111111100001111000
0000111111111001111111100011111000
0001111100011111111111111111111000
0001111100001111111111111111111000
0001111110000111111111111111111000
0001111100000111111011111111111000
0001121000001111111111111111111000
0000111000001111111111111111111000
0000110000000111111111111111111000
0000000000000000111111111100110000
0000000000000000011111110000000000
0000000000000000000000000000000000
0000000000000000000000000000000000
0000000000000000000000000000000000
0000000000000000000000000000000000
