0000000000000000000
0000000000000000000
0000000000000000000
0000000011000000000
0000000111111000000
0000000111131100000
0000000111111100000
0000001110011100000
0000011100011110000
0000111110011110000
0001111111111110000
0001111111111110000
0000121111001110000
0000000000000110000
0000000000000000000
0000000000000000000
0000000000000000000
0000000000000000000
0000000000000000000