0000000000000000000000000000000000
0000000000000000000000000000000000
0000000000000000000000000000000000
0000000000000000000000000111100000
0000000000000111111000001121110000
0000000000001111111110001111110000
0000000000001111100111000111110000
0000000000001111000011000111100000
0000001100011110000001111111100000
0000011111111100000001111111110000
0000011111111000000000111111111000
0000011100110000000000111111111000
0000111100000011000001111111111000
0000111100000111111111111111111000
0000111111111100011110000111111000
0000111111111000000000000011111000
0001111111111000000000000011110000
0001111111111100000000110111100000
0001111111111110000011111111100000
0001111111100111100111111111110000
0000000111000001111111111111110000
0000000011000000111111111111110000
0000000011000000111111100001110000
0000001111100001110111100000110000
0000111111110011100011100000110000
0000111111111111100011111001110000
0000131111111111100011111111110000
0000111000111111100011111111110000
0000000000000001111111111111110000
0000000000000000111111111111100000
0000000000000000011111111100000000
0000000000000000000000000000000000
0000000000000000000000000000000000
0000000000000000000000000000000000
