0000000000000000000
0000000000000000000
0000000000000000000
0000000000000110000
0000011000001111000
0000121100001131000
0000111100000111000
0000111100000110000
0000111110001100000
0000111111111100000
0000111111111100000
0000111110111100000
0000111100111110000
0000111110111110000
0000111111111100000
0000011110000000000
0000000000000000000
0000000000000000000
0000000000000000000