0000000000000000000000000000000000
0000000000000000000000000000000000
0000000000000000000000000000000000
0000110000000000001110000000000000
0001111111111111111111000000000000
0001311111111111110011100000000000
0001111000000000000011110000000000
0000110000000000000011110000000000
0000110000000000001111110000000000
0000011000000000111111110000000000
0000011000000011111111100000000000
0000011000001111111111000000000000
0000011000011111111111000000000000
0000110000111000111110000001100000
0001110000110000011110000011110000
0001110000110000111111111111111000
0000111001100001111111111011111000
0000011111100011111111110001110000
0000011111110111111100000011110000
0000011111111111111000011111100000
0000111111111111111000111111100000
0000111111111111111111111001110000
0000111111111111111111110000100000
0000111111101111111111110000000000
0001111111100111100111111000000000
0001111111101111000011001111100000
0001111111111110000000000111110000
0001111111111100000000000111110000
0000111111111100000000000111110000
0000011111111000000000000112110000
0000001100000000000000000011100000
0000000000000000000000000000000000
0000000000000000000000000000000000
0000000000000000000000000000000000
