0000000000000000000000000000000000
0000000000000000000000000000000000
0000000000000000000000000000000000
0000000000001110000000000000000000
0000000000011111111000011111000000
0000000000111111111100111111100000
0000000000111111111111111141100000
0000000000111111111111111111000000
0000000000111111111111111111000000
0000000000111111111111111111100000
0000000001111100111111111111100000
0000001111111000011111111111100000
0000011111111000011110011111000000
0000111111111000011100011110000000
0000111111111100111100001100000000
0000111111000111111100001100000000
0000011110000011111110011110000000
0000011110000001111111111111100000
0000111111000001111111111111110000
0000111111100001111000011111110000
0000111111110011111000001111110000
0000111111111111111100001111110000
0000111111111111111110011111110000
0000111111111111011111111111100000
0000111111111110001111111111100000
0000111111111110000111111111100000
0000121111111110000011011111110000
0000111111111111000000001111110000
0000011001111111000000001111110000
0000000000011110000000000111100000
0000000000000000000000000000000000
0000000000000000000000000000000000
0000000000000000000000000000000000
0000000000000000000000000000000000
