000000000000000000000000
000000000000000000000000
000000000000000000000000
000000000000111111000000
000000000011111111100000
000000000111114111110000
000000001111111111110000
000000011111111111110000
000000011111100111110000
000000111111000011110000
000000111110000011110000
000001111110000011100000
000011111110000011100000
000011100111000011100000
000011000011000001110000
000011000001100001110000
000011000001110011110000
000011100011111111110000
000011111111111111100000
000011211110000000000000
000001110000000000000000
000000000000000000000000
000000000000000000000000
000000000000000000000000
