00000000000000000000000000000
00000000000000000000000000000
00000000000000000000000000000
00000000000000001111000000000
00000000111111111111100000000
00000001111111111121111110000
00000011000001111111111111000
00000110000000111111111111000
00000110000000111111111111000
00000110000001111111111111000
00000110000001111111111111000
00000110000001111110001111000
00001110000000111100000111000
00001111000000001100000110000
00001111100000000100000110000
00001111110000000000000110000
00001111110000000001000110000
00001111110000111111111110000
00001111110001111111111110000
00001111111111111111111110000
00001111111111100111111100000
00001111111111000011100000000
00001111111111000011000000000
00001131001111100110000000000
00000110000111111100000000000
00000000000011111000000000000
00000000000000000000000000000
00000000000000000000000000000
00000000000000000000000000000
