000000000000000000000000000000000000000000000000000000
000000000000000000000000000000000000000000000000000000
000000000000000000000000000000000000000000000000000000
000000000000000011000000111000000000000000000110000000
000000000001111111100111111100001111110000001111100000
000000011111111111111111001110011111111110011111110000
000000111111111111111100000011111111001111110000111000
000000111111111111111000000001111110000111100000011000
000001111111111111111000000000011110000111000000011000
000001111111111111111000000000001111001111000000011000
000011111000001111111000000000001111111111100000110000
000011110000000111110000111000001111111311110000110000
000011111000000111111001111110000111111111111001110000
000011111100001111111111111111000001111111111111100000
000011111110001111111111111111000000111111111111000000
000011111111000111111111111111000000111111101111000000
000011101111100111111111111111000001111111000111000000
000011000111100011111111111111000001111111000011000000
000011000011100011100111111111100000111111000011100000
000011000001110001000011111111110000011110000011100000
000011000001111000000001111111110000000000000111100000
000011100011111100000001111111100000000000001111000000
000011111111111111000011111111100000110000011110000000
000011111111111111111111111111100001111000111110000000
000011111111111111111111001111000001111111111111000000
000111111111111111111110000111000000111111111111100000
000111111111111100000110000111000000111111111111100000
000111111111111000000011000011100000111111111111110000
000111111111111000000011000001111001111111111111110000
000111111111111000000011100011111111111111111111110000
000011111111110000000011111111111111111101111111111000
000011111111000000000111111111111111111000111111111000
000001111110000000001111111111111111111111111111110000
000001111110000000011111111000011100011111111111110000
000001111110000000011111110000001100000111111111110000
000011110000000000111111110000001100000011111111111000
000011100000011111111111111000001100000011111111111000
000111110000111111111111211100011110000011111111111000
000111111111111111111111111111111111000011111111111000
000111111111111111111111111111111111100011111111111000
000111111111111000001111111111111111111111111111110000
000111111111100000000111111111100111111111111111100000
000111111111000000000011111111000011111111111111000000
000011100111100000000011111100000001111111111110000000
000011000011110000000111111000000001111001111110000000
000000000011111000111111111100111001111000001111000000
000000000011111111111111111111111111111000000111100000
000000000011001111111111111111111111111100000111110000
000000000000000111001111111111111111111100000111110000
000000000000000000000111100000001111111000000111110000
000000000000000000000000000000000111110000000011100000
000000000000000000000000000000000000000000000000000000
000000000000000000000000000000000000000000000000000000
000000000000000000000000000000000000000000000000000000