000000000000000000000000000000000000000000000000000000
000000000000000000000000000000000000000000000000000000
000000000000000000000000000000000000000000000000000000
000000000000000000000000011100000000000000000000000000
000001111000001111110000111111111000011000000111100000
000011111100011111111001111111111111111100001111110000
000011111111111110011111111000111111111100001111110000
000011111111111100001111111000111111111100011111110000
000011111111111100001111111101111111111111111111110000
000011110001111100001111111111111111111111111111110000
000011110000111100001110011111111111111111111111110000
000011110000111100001100001111111111000011111111110000
000011111000011100001100000111111110000000011111110000
000011111000011110000110000110001100000000001111110000
000011110000111110000011000110000000000000001111110000
000001110000111110000011101110000000000000000111110000
000000111001111100000011111111000000000000000011110000
000000111111111000000011111111111000000000000011110000
000000111111111000000001111111111100000000000111110000
000000111000111100000001111111111110000000001111110000
000000010000011111100011111111111111100000001111110000
000000000000011111111111112111111111111110000111110000
000000000000011111111111111111111111111111000011110000
000000000000111111111111111111111111111111100001110000
000000000011111100110011111111100111111111100000110000
000000111111111100000011111110000011111111100000000000
000000111111111100110011111100000011111111000000000000
000000000001111111111111111100000011111110000000000000
000000000000111111111111111100000011111110000000000000
000000000000111001111111111110000111111111000000000000
000000000000110000001111100111000111111111100000000000
000001111000110000000111000011000011111111100000000000
000011111100111000000111000011100011111111100000000000
000011111100011000001111100111110001111111000000110000
000011111100011000011111111100111000111110000001111000
000011111100011100111011111000011110111110000011110000
000001111100011111110001111000001110001111000111100000
000000111100111111100011111100000111000111111111000000
000000011000111111000111111111000111000111111111000000
000000011000111110001111111111111111000111111110000000
000000111000011000001111111111111110000111111100000000
000000111000000000001111111110001100000011111000000000
000001111100000000011111111100000000000001110000000000
000001111110000000111001111000000000000000000000000000
000011111110000000110000110000000000000000000000000000
000011111110000000110000000000000001100000000000000000
000011111111000001110000000000000011111000000000000000
000001111111111111111000000000000111111100000000000000
000001111111111111111111111111111111311111100000000000
000000111111111110001111111111111111100111100000000000
000000011110000000000000001100000011000000000000000000
000000000000000000000000000000000000000000000000000000
000000000000000000000000000000000000000000000000000000
000000000000000000000000000000000000000000000000000000