00000000000000000000000000000
00000000000000000000000000000
00000000000000000000000000000
00000011000000000000000000000
00000111111000000000000000000
00000113111100000100000000000
00000011111100001110000000000
00000011111110011100000000000
00000111111111111000000000000
00001111111111110000000011000
00001111111111100000000011000
00001111111111100000000021000
00000111111111100000000110000
00000111111111100001111110000
00000111111111100011111110000
00000111111111100011111110000
00000111111111000011111110000
00000111111100000001111110000
00000111111000000000111100000
00000011110000000000011100000
00000001110000000000011100000
00000001111000000000111110000
00000000111111111001111110000
00000000111111111111111110000
00000000011111111110001100000
00000000000111111000000000000
00000000000000000000000000000
00000000000000000000000000000
00000000000000000000000000000