000000000000000000000000000000000000000000000000000000
000000000000000000000000000000000000000000000000000000
000000000000000000000000000000000000000000000000000000
000000000000000000000000000000000010000000000000000000
000000000000001111110000000000000111110000000000000000
000000000000011111111100001110000011311000000000000000
000000110000011111111110011110000001111100000000000000
000001111000011111111111111110000000111110000000000000
000001121100000001111111111000000000111111000001100000
000000111110000000111111110000000000011111100011110000
000000011110000000111111110000000000011111111111110000
000000001111000001111111111000000000111111111111110000
000000000111000111111111111111111111111111111111110000
000000011111001111111111111111111111111111111111110000
000000111110000111111101111111111111111111111111100000
000000111110000000111111111111111111111111111111100000
000000111110000000011111111101100011111111111111100000
000000011100000000001111111001100011111111111111100000
000000011100000000000001110001110011111111111111110000
000000011000000110000000000001111111111100011111110000
000000011000001111000000000011111111111100011111110000
000000011000011111100000000111111111111100001111100000
000000111000110001110001111111111111111100000011100000
000001111101111011111111111111111111111000000001100000
000001111111111111111111111111111111111000000000110000
000001111111111111111111111111111100011000000000110000
000000111111111111111100000111111100001100000000110000
000000011111111111111000000011111110011100000001110000
000000011111111111111000000001111111111100011111111000
000000111111111111111100000001100011111000011111111000
000001111111111111111100000011100011100000000011111000
000011111101111111111110001111000011000000000001110000
000011111000111111111111111111000011000000000011110000
000011111101111111001111111111000011000000111111100000
000001111111111111000000111111100110000000111111000000
000000111111111111000000011111111110000000011110000000
000000111111111111110000011111111110000000011110000000
000000111111111111110000011001111111000000111110000000
000000111111111111110000110000111111000000111110000000
000000111111110111100000110000111111000000111111000000
000001111111100011100000110000111110000000001111000000
000001111111100111000000011001111110000000000111000000
000001111111000111000000011111111111000011101111000000
000011111110000010000000111111111111111111111111100000
000011111110000000000001111111111111111111110011110000
000011111111000000000011110011111111111111100001110000
000011111111110000000111110011111111111111000000110000
000001111111111000000011100001111111111000000000110000
000001111111111000000000000000111111111000000001110000
000000111111110000000000000000011111111000000000100000
000000000000000000000000000000000001110000000000000000
000000000000000000000000000000000000000000000000000000
000000000000000000000000000000000000000000000000000000
000000000000000000000000000000000000000000000000000000