00000000000000000000000000000
00000000000000000000000000000
00000000000000000000000000000
00000000000000000000011100000
00000000000000011000121110000
00000000000000111111100110000
00000000011001111111000011000
00000000111111111110000000000
00000001111111111000000000000
00000001111111110000000000000
00000001111111110000011000000
00000011111111110000111100000
00000111111111111000011110000
00001111111111111100001110000
00001111111111111111001110000
00001111111111111111111100000
00001111111111111111111000000
00001111111111100111110000000
00001110000111000011100000000
00001100000000000111100000000
00000000000000001111100000000
00000000000000011111110000000
00000000000111111111110000000
00000011311111111111100000000
00000011111111000111000000000
00000000000000000000000000000
00000000000000000000000000000
00000000000000000000000000000
00000000000000000000000000000