00000000000000000000000000000
00000000000000000000000000000
00000000000000000000000000000
00000000000000000000001100000
00000111100011111111111110000
00001111111111111111111110000
00001110011111110000011100000
00001100001111100000001100000
00001100001111100000001100000
00000110001111110000011100000
00000111111111111000011110000
00000111111100011100001111000
00000111111100001110001111000
00001111111100001100001111000
00001111111110011000001111000
00001111111111111000001110000
00001110011111111000000000000
00001100001111111100000000000
00001100001111111111000000000
00001100000111111111100000000
00001110000111111111110000000
00000111001111111111110000000
00000011111111111111111000000
00000000111111111111111000000
00000000000000111111110000000
00000000000000000000000000000
00000000000000000000000000000
00000000000000000000000000000
00000000000000000000000000000