000000000000000000000000000000000000000000000000000000
000000000000000000000000000000000000000000000000000000
000000000000000000000000000000000000000000000000000000
000000000000000110000000000000000000000000011000000000
000000000000001111000011111111100000000000111100000000
000001110000001111100111111111110001110001111110000000
000011111110001111111111111111111111111111131110000000
000011111111001111111111111111111111111111111110000000
000011101111111111111111110000001111111111111111000000
000011000111111111111111100000000111111111111111100000
000011000111111111100011100000000000111111111111110000
000011000111001111000011100000000000111111111111111000
000011000110000110000011100000001000111111111101111000
000011111110000110000001110000011111111111111000110000
000011111110001110000000111100001111111111110000110000
000011111111111110000000011110000000110000000000110000
000011111111111110000000011111110000000000000000110000
000011111111001111000000111111111110000000000000110000
000011000110000111110001111110011111000000000000110000
000010000110000001111111111100001111000000000001110000
000110000110000000001111111100001111000000011111110000
000110000011000000000111111110011110000000111111110000
000000000011100000000111111111111100000000111111110000
000000000111111100001111111111111000000001111111110000
000000011111111111111111111111000000001111100111110000
000000111111101111111111111110000000111110000011110000
000000111111100111111111111100000111110000000111110000
000001111111101111111100000000011111100000111111110000
000011110001111111111000000000111111100011111111110000
000011100001111110000000000001111111100111000001110000
000011110011111000000000000001111111111110000001100000
000011111111111000000000000000111111111000000011000000
000111111111111000000000000000111111110000000011000000
000111111111111110000000000000111111110000000011000000
000011111111111111000001110001111111110000000011100000
000000011111001111100011111111111111111000000001110000
000000001111001111111111111111111100111100000001110000
000000001111001111111111000001111000011100000001100000
000000001111111111111110000000111000011110000011100000
000000011001111111111111110000011100111111111111110000
000000110000011111111111111000011111111111111111110000
000001100000001111111111111000111111111110011111110000
000011000000011111111111111111110000011100001111110000
000011000001111111111111111111100000001100001111100000
000011100001111111111111111111100000000110011111000000
000011110001111111111111111111100000000111111110000000
000012110000111111111111111111100000001111111100000000
000011110000111111111111111111110001111111111110000000
000001100000111111111000111111111111100011111111000000
000000000000011111110000011000111111000000001111000000
000000000000000000000000000000011110000000000000000000
000000000000000000000000000000000000000000000000000000
000000000000000000000000000000000000000000000000000000
000000000000000000000000000000000000000000000000000000