00000000000000000000000000000000
00000000000000000000000000000000
00000000000000000000000000000000
00000000011001110000000001110000
00001111111111111000000111111000
00011111111111001100001111111000
00011111111110000110001111110000
00001111111110000111111100000000
00001111111110000011111100000000
00011111111111000011111100000000
00011111111111111111111100000000
00011111111111111111111110000000
00001110000111111111111111110000
00001100000011111111111111111000
00001100000011111111111111111000
00001100000111111111111111110000
00000110001111111111111111110000
00000111111111111111111111110000
00000111111111000001111111110000
00000110011100000000111111110000
00001100000000000000011111110000
00011100000000000000011111110000
00011110000000000000111111110000
00001111000000000011111111110000
00000111100000000111111111110000
00000111111100001111111111110000
00000111111111111100001111110000
00000011000011111000000111100000
00000000000000000000000011000000
00000000000000000000000000000000
00000000000000000000000000000000
00000000000000000000000000000000