000000000000000000000000000000000000000000000000000000
000000000000000000000000000000000000000000000000000000
000000000000000000000000000000000000000000000000000000
000000000000000111110001111110000000000000000000000000
000001110000001111111111111111100000011111111111100000
000011111000001110000111111111110000111111111111110000
000011111000001100000011111111110001110011111111111000
000011111000001100000001111111111111100001111111111000
000011111100001100000011111111111111100001111110111000
000011111100001100001111111111111111000011111100011000
000001111110011110011111111110011100001111111000011000
000000111111111111111111111100000000011111100000110000
000000111111111111111111111100000000011111000111110000
000001111111111111111111111000000000111111001111100000
000011111111111111111111111000000001111111001111000000
000011111111111111111111111000000011111111001111000000
000111111111111111111111111000000111111111000111100000
000111111111111111101111111000000111111110000011110000
000000000011111111100111111000000111111000000001110000
000000000011111111101110001100000111110000000001100000
000000100011110011111100000111111111100000000001100000
000001111111100001111000000111111111100000000011100000
000011111111110011111000000111111111110000011111110000
000011111111111111111100001111111111110000111111110000
000011101111111111111111111111100011111001111111100000
000011000111111111111111111111100011111111111111100000
000011000111111111111111111111000001111111111111100000
000011111111100111111141111111000000111111111111100000
000001111111000011111111111111000000000011111111110000
000000111111000011111111111111000000000001110001110000
000000111111100001111111111111100000111000000001110000
000001111111110000111111111111110001111100000001110000
000011111110110000111111111111110001111100000011110000
000011111100011001110000011111111001111110000111100000
000001111100011111100000001111111000111110000111000000
000001111100011111100000000111111000011111000111000000
000001111000011111000000000111110000011111100111000000
000001110000001100000000000111110000011111100111100000
000001100000000000000000001111111000011111100011110000
000001100000000000000000011111111000001111000011111000
000011111110000000000000111101111100000111000011111000
000011111111000000000001111000111110000111100111111000
000011111111100000000001111101111110000111111111110000
000011111111110000000001111111111111001111111111110000
000011111111111000000001111111100111111111001111110000
000011111111111000000001111111000011111110000111111000
000011111111111100000011111111000011111111001111111000
000011121111111110000111111111100111111111111111111000
000011111111000111111111111111111111111111111111111000
000001111110000000111111111001111111111111111111110000
000000000000000000001100000000000000000000000000000000
000000000000000000000000000000000000000000000000000000
000000000000000000000000000000000000000000000000000000
000000000000000000000000000000000000000000000000000000